Channel|keyword|\bchannel\b
Chroma|keyword|\bchroma\b
Domain|keyword|\bdomain\b
Grandeur|keyword|\bgrandeur\b
Hellbent|keyword|\bhellbent\b
Imprint|keyword|\bimprint\b
Join forces|keyword|\bjoin forces\b
Kinship|keyword|\bkinship\b
Landfall|keyword|\blandfall\b
Metalcraft|keyword|\bmetalcraft\b
Morbid|keyword|\bmorbid\b
Radiance|keyword|\bradiance\b
Sweep|keyword|\bsweep\b
Threshold|keyword|\bthreshold\b
Affinity|keyword|\baffinity\b
Amplify|keyword|\bamplify\b
Annihilator|keyword|\bannihilator\b
Aura swap|keyword|\baura swap\b
Banding|keyword|\bbanding\b
Battle cry|keyword|\bbattle cry\b
Bloodthirst|keyword|\bbloodthirst\b
Bushido|keyword|\bbushido\b
Buyback|keyword|\bbuyback\b
Cascade|keyword|\bcascade\b
Champion|keyword|\bchampion\b
Changeling|keyword|\bchangeling\b
Conspire|keyword|\bconspire\b
Convoke|keyword|\bconvoke\b
Cumulative upkeep|keyword|\bcumulative upkeep\b
Cycling|keyword|\bcycling\b
Deathtouch|keyword|\bdeathtouch\b
Defender|keyword|\bdefender\b
Delve|keyword|\bdelve\b
Devour|keyword|\bdevour\b
Double strike|keyword|\bdouble strike\b
Dredge|keyword|\bdredge\b
Echo|keyword|\becho\b
Enchant|keyword|\benchant\b
Entwine|keyword|\bentwine\b
Epic|keyword|\bepic\b
Equip|keyword|\bequip\b
Evoke|keyword|\bevoke\b
Exalted|keyword|\bexalted\b
Fading|keyword|\bfading\b
Fear|keyword|\bfear\b
First strike|keyword|\bfirst strike\b
Flanking|keyword|\bflanking\b
Flash|keyword|\bflash\b
Flashback|keyword|\bflashback\b
Flying|keyword|\bflying\b
Forecast|keyword|\bforecast\b
Fortify|keyword|\bfortify\b
Frenzy|keyword|\bfrenzy\b
Graft|keyword|\bgraft\b
Gravestorm|keyword|\bgravestorm\b
Haste|keyword|\bhaste\b
Haunt|keyword|\bhaunt\b
Hexproof|keyword|\bhexproof\b
Hideaway|keyword|\bhideaway\b
Horsemanship|keyword|\bhorsemanship\b
Infect|keyword|\binfect\b
Intimidate|keyword|\bintimidate\b
Kicker|keyword|\bkicker\b
Multikicker|keyword|\bmultikicker\b
Landwalk|keyword|\blandwalk\b
Level up|keyword|\blevel up\b
Lifelink|keyword|\blifelink\b
Living weapon|keyword|\bliving weapon\b
Landcycling|keyword|\blandcycling\b
Madness|keyword|\bmadness\b
Modular|keyword|\bmodular\b
Morph|keyword|\bmorph\b
Ninjutsu|keyword|\bninjutsu\b
Offering|keyword|\boffering\b
Persist|keyword|\bpersist\b
Phasing|keyword|\bphasing\b
Poisonous|keyword|\bpoisonous\b
Protection|keyword|\bprotection\b
Provoke|keyword|\bprovoke\b
Prowl|keyword|\bprowl\b
Rampage|keyword|\brampage\b
Reach|keyword|\breach\b
Rebound|keyword|\brebound\b
Recover|keyword|\brecover\b
Reinforce|keyword|\breinforce\b
Replicate|keyword|\breplicate\b
Retrace|keyword|\bretrace\b
Regenerate|keyword|\bregenerate\b
Ripple|keyword|\bripple\b
Shroud|keyword|\bshroud\b
Soulshift|keyword|\bsoulshift\b
Splice|keyword|\bsplice\b
Split second|keyword|\bsplit second\b
Storm|keyword|\bstorm\b
Sunburst|keyword|\bsunburst\b
Suspend|keyword|\bsuspend\b
Totem armor|keyword|\btotem armor\b
Trample|keyword|\btrample\b
Transfigure|keyword|\btransfigure\b
Transmute|keyword|\btransmute\b
Unearth|keyword|\bunearth\b
Vanishing|keyword|\bvanishing\b
Vigilance|keyword|\bvigilance\b
Wither|keyword|\bwither\b
Extort|keyword|\bextort\b
Cipher|keyword|\bcipher\b
Bloodrush|keyword|\bbloodrush\b
Battalion|keyword|\bbattalion\b
Evolve|keyword|\bevolve\b
Gates|keyword|\bgates\b
Tap/Untap|mined|\b(tap(s|ped)?|untap(s|ped)?)\b
Sacrifice|mined|\bsacrifices?\b
Search|mined|\bsearchs?\b
Reveal|mined|\breveals?\b
Hand|mined|\bhands?\b
Shuffle|mined|\b(re)?shuffles?\b
Target|mined|\btargets?\b
Creature|mined|\b(creatures?|[0-9]*/[0-9]*)\b
Player|mined|\bplayers?\b
Power/Toughness|mined|([\+\-][0-9]/[\+\-][0-9])|\b(power|toughness)\b
Upkeep|mined|\bupkeeps?\b
Name|mined|\bnamed?\b
Remove|mined|\bremoves?\b
Turn|mined|\bturns?\b
Mana|mined|\bmanas?\b
Attack|mined|\b(non)?attack(ing|s|ed)?\b
Defend|mined|\b(non)?defend(ing|s|ed)?\b
Block|mined|\b(non)?block(ing|s|ed)?\b
Discard|mined|\bdiscards?\b
Look|mined|\blooks?\b
Choose|mined|\bchooses?\b
Color|mined|\bcolor(s|ed|less)?\b
Life|mined|\blifes?\b
Control|mined|\bcontrol(s|ler)?\b
Owner|mined|\bowners?\b
Graveyard|mined|\bgraveyard\b
Activation|mined|\bactivat(e|ion)\b
Draw|mined|\bdraws?\b
Permanent|mined|\bpermanents?\b
Blue|mined|\b(non)?blue\b
Black|mined|\b(non)?black\b
White|mined|\b(non)?white\b
Green|mined|\b(non)?green\b
Red|mined|\b(non)?red\b
Counter target spells|mined|\bcounter\s+target\s+spell\b
Destroy|mined|\bdestroys?\b
Cost|mined|\bcosts?\b
Cumulative|mined|\bcumulatives?\b
Counter|mined|\bcounters?\b
Combat|mined|\bcombats?\b
Battlefield|mined|\bbattlefields?\b
Game|mined|\bgames?\b
Attach|mined|\battach(ed)?\b
Step/Phase|mined|\b(step|phase)\b
Random|mined|\brandoms?\b
Mountain|mined|\bmountains?(walk)?\b
Plain|mined|\bplains?(walk)?\b
Swamp|mined|\bswamps?(walk)?\b
Forest|mined|\bforests?(walk)?\b
Island|mined|\bislands?(walk)?\b
Bury|mined|\bburys?\b
Token|mined|\b(non)?tokens?\b
Library|mined|\blibrarys?\b
Gain|mined|\bgains?\b
Flip|mined|\bflips?\b
Exile|mined|\bexiled?\b
Summon|mined|\bsummon(ing)?\s+sick(ness)?\b
Ante|mined|\bantes?\b
Type|mined|\btypes?\b
Return|mined|\breturns?\b
Indestructible|mined|\bindestructibles?\b
Opponent|mined|\bopponents?\b
Face|mined|\bfaces?\b
Pay|mined|\bpays?\b
Interrupt|mined|\binterrupts?\b
